1111111111111
100100000P001
100001C011001
100011E000001
1111111111111
