111111111111111111111111111111
1P0000000000000000000000000001
10111111C111111100111011111101
100000010000000000000000000101
101C00010111101111111110111101
101111010000000000000010100001
101C01011111111100111010101101
1010010000000000000010001010C1
101001111111101111101000101001
101000000000001C00001000101001
101111001111101111111010101001
100000000000100000000010101001
101000011111101111011010101001
101C00000000001C01010010101001
10111111101000100101C010101001
100000001011111001011111101001
1011111010000000000000000C1001
100000101011111111111111111001
10111010001C0000000C1000000001
101000101010111111111011111101
101010101010000000001C00000101
101010101010111111111111110101
101C10101010100000000000010101
101110101010111010000000010101
101000101010001011111111010101
1010101010101C0010000001010101
101C1C101010111110100000010101
101111101011100000111111110101
1000000000000000000000000000E1
111111111111111111111111111111
