1111111111111
1PCE000000001
1111010111001
1000110000001
1111111111111
